011111111111111111110
011222111111111222110
012222222212222222210
013112111212111211310
012222222222222222210
012112121111121211210
012222122212221222210
011112111010111211110
000012100000001210000
111112101101101211111
000002001000100200000
111112101111101211111
000012100000001210000
011112101111101211110
012222222212222222210
012112111212111211210
013212222202222212310
011212121111121212110
012222122212221222210
012111111212111111210
012222222222222222210
011111111111111111110