111111111111111111111
111222111111111222111
112222222212222222211
113112111212111211311
112222222222222222211
112112121010121211211
112222122212221222211
111112111010111211111
100002100000001200001
111112101101101211111
000002001000100200000
111112101111101211111
100002100000001200001
111112101111101211111
112222222212222222211
112112111212111211211
113212222202222212311
111212121111121212111
112222122212221222211
112111111212111111211
112222222222222222211
111111111111111111111